Student Name 	Team Name	Instructor Name	Academy 

Yassen ibrahem hussien elashry	Tech Protal	Nada Ibrahim Elborhamy	Techno Kids Techno Future kfs
Ahmed Alaa Abosalah	Tech Protal	Nada Ibrahim Elborhamy	Techno Kids Techno Future kfs
			
Adam ahmed shehata skeen	Black eagle	Nada Ibrahim Elborhamy	Techno Kids Techno Future kfs
Mohamed Abdelghany mohamed	Black eagle	Nada Ibrahim Elborhamy	Techno Kids Techno Future kfs
Osama Abdelghany mohamed	Black eagle	Nada Ibrahim Elborhamy	Techno Kids Techno Future kfs
Ahmed Medhat Elshamy 	Black eagle	Nada Ibrahim Elborhamy	Techno Kids Techno Future kfs
			
Lana ahmed el beshbeshy	YOLO	Salma Ahmed Mohamed Gad	Techno Kids Techno Future kfs
Shadwa Waleed El-BeshBishy	YOLO	Salma Ahmed Mohamed Gad	Techno Kids Techno Future kfs
Youssif Waleed El-BeshBishy	YOLO	Salma Ahmed Mohamed Gad	Techno Kids Techno Future kfs
			
Abd El Rahman Ahmed attia	Fossils scientist team	Nada Ibrahim Elborhamy	Techno Kids Techno Future kfs
Mazen Osama Mohammed	Fossils scientist team	Nada Ibrahim Elborhamy	Techno Kids Techno Future kfs
Adham Osama  Mohammed	Fossils scientist team	Nada Ibrahim Elborhamy	Techno Kids Techno Future kfs
Yasin Mostafa Ismaeil Sakran	Fossils scientist team	Nada Ibrahim Elborhamy	Techno Kids Techno Future kfs
			
Kenzy Mohamed abd el shafy 	The black horse	Nada Ibrahim Elborhamy	Techno Kids Techno Future kfs
			
Mohamed mahmoud ibrahim yousef elbahlol		Salma Ahmed Mohamed Gad	Techno Kids Techno Future kfs
			
Mohamed Ahmed Ali Zain El-Abdieen	Mz Explodes		Techno Kids Techno Future kfs
			
Albraa Reda Alsaeed	ctrl	Salma Ahmed Mohamed Gad	Techno Kids Techno Future kfs
			
Mohamed Wael Aboskien			Techno Kids Techno Future kfs
			
Marwan Abdo Ali Elmansy	Scientific stars		Techno Kids Techno Future kfs
			
Omar Hosam Hamisa	Electro	Salma Ahmed Mohamed Gad	Techno Kids Techno Future kfs
			
Farida Mohamed mahmoud Hessen	دلع كرشك	Salma Ahmed Mohamed Gad	Techno Kids Techno Future kfs
			
Eman Ayman Abu Shaisha Abdel Aziz	ساعه لقلبك		Techno Kids Techno Future kfs
			
			
			
			
			
			
			
			
			
			
			
			
			
			
			
			
			
			
			
			
			
			
			
			
			
			
			
			
			
			
			
			
			
			
			
			
			
			
			
			
			
			
			
			
			
			
			
			
			
			
			
			
			
			
			
			
			
			
			
			
			
			
			
			
			
			
			
